1111111111111
10P00000C0001
1000010000C01
10C0010C00E01
1111111111111
