11111111111
1C100E00001
101000000C1
10101101111
1C0000000P1
11111111111