11111111111111111111111111111111111111111111111111
1C000000000000100000000111100000P00000000000000001
1111000010000C101000000000001111110011110000000001
10001000100011101010000000001C10000000011111111111
1000100C100000001C100000000000100000000000000E0001
11111111111111111111111111111111111111111111111111